{
	"town": {
        	"terrain": [
                "################################",
                "#                              #",
                "#               ==========     #",
                "#    =%=        =        =     #",
                "#    = =        ====%+====     #",
                "#    =+=                       #",
                "#                              #",
                "#                              #", 
                "#              ===+=%%%%=====  #",
                "#    ===-===   =            =  #",
                "#    =   = =   %            =  #",
                "#    =   =-=   %            =  #",
                "#    =     =   =            =  #",
                "#    ==%====   =====%%-%%====  #",
                "#                              #",
                "#     ...                      #",
                "#     .T.                      #",
                "#     ...                      #", 
                "#                              #",
                "#                              #",
                "#   ======+====                #",
                "#   =         =                #",
                "#   =         =                #",
                "#   ==%==%==%==                #",
                "#                              #",
                "#                              #",
                "#============+++++++===========#",
                "#....,....,.............,......#", 
                "#...,...T....,.......,T...,...,#",
                "#,.....,...,...,,.....,.....,T.#",
                "#....,...........,.............#",
                "###############000##############"
        	]
	}
}
